XXXXXXXXXXXXXXXXXXXXXXXXXXX
X1111111111122222222222333X
X3XXXXX12222222222221XXXXXX
X3XXXX122222211111111aXXXXX
X3XXX222211111X12222222XXXX
X2XX333344444XXX12222222XXX
X2X333344444XXXXX12222222XX
X22233334444bXXX1222222222X
X2222211111111X11111111111X
XXX222211111111111c222222XX
XXXXXX22111111112222222XXXX
XXXXXXX22211112222222XXXXXX
XXXXXXXd222111222222XXXXXXX
XXXXXXXXXX22111222XXXXXXXXX
XXXXXXXXXXXXXXXXXXXXXXXXXXX